wczoraj - gestern
rozumieć - verstanden
znowu - wieder
znać - kennen
uniwersytet - die Universität
marker - der Marker
bułka - das Brötchen
dach - das Dach
słodki - süß
światło - das Licht
stopa - der Fuß
odjazd - die Abfahrt
biedny, ubogi - arm
exit - der Ausgang
broda - der Bart
wiek - das Alter
pszczoła - die Biene
krzak - der Busch
bluza - das Sweatshirt
t-shirt - das T-Shirt
okulary - die Brille
koszula - das Hemd
mięsień - der Muskel
zabawny - lustig
brzydki - hässlich
pyszny - lecker
salty - salzig
zdanie (ciąg wyrazów) - der Satz
pluć - spucken
drewno - das Holz
gąbka - der Schwamm
toothbrush - die Zahnbürste
ząb - der Zahn
szczotka - die Bürste
pasta do zębów - die Zahnpasta
ptak - der Vogel