walizka - der Koffer
wózek dziecięcy - der Kinderwagen
należeć do kogoś - gehören
mapa - die Landkarte
lalka - die Puppe
pielęgniarka - die Krankenpflegerin
klinika - die Klinik
fabryka - die Fabrik
kasjer - der Kassierer
członek - das Mitglied
orkiestra - das Orchester
człowiek - der Mensch
strażnik - der Wärter
karmić - füttern
odpowiadać - antworten
aresztować - verhaften
naukowiec - der Wissenschaftler
obserwować - beobachten
pozdrawiać, powitać - begrüßen
doradzać, radzić - beraten
kochać - lieben
żyć - leben
kapitan - der Kapitän
posługiwać się, obsługiwać - bedienen
bratanek, siostrzeniec - der Neffe
niedźwiedź - der Bär
prezydent - der Präsident
pilot (samolotu) - der Lotse
klient - der Kunde
ekspert - der Experte