konstruować - konstruieren
rozkazywać - befehlen
książe - der Fürst
gazeta - die Zeitung
drukować - drucken
printer - der Drucker
witness - der Zeuge
zając - der Hase
żreć (o zwierzętach) - fressen
lew - der Löwe
rabbit - das Kaninchen
prison - das Gefängnis
prisoner - der Gefangene
uwalniać - befreien
słowo - das Wort
litera - der Buchstabe
brakować - fehlen
sąsiad - der Nachbar
kłuć, użądlić - stechen
mosquito - die Mücke
painful - weh
czynić, robić, wyrządzać - tun
spadek, dziedzictwo - das Erbe
spadkobierca - der Erbe
niewolnik - der Sklave
filozof - der Philosoph
głupiec(2) - der Tor / der Narr 
sprzeczać się - streiten
nigdy - niemals
życzyć - wünschen
mieszkaniec - der Einwohner