calculator - der Taschenrechner
settings - die Einstellungen
calendar - der Kalender
phone - das Telefon
dictionary - das Wörterbuch
pan - die Pfanne
hospital - das Krankenhaus
scissors - die Schere
bin - der Mülleimer
platform - der Bahnsteig
Wednesday - der Mittwoch
Monday - der Montag
computer - der Computer
noteboook - das Heft
camera - die Kamera
candle - die Kerze
grass - das Gras
plant - die Pflanze
finger - der Finger
hair - das Haar
Tuesday - der Dienstag
Friday - der Freitag
Saturday - der Samstag
Sunday - der Sonntag
dormitory - das Wohnhein
track - das Gleis
shop(2) - das Geschäft / der Laden
pot - der Topf
mouth - der Mund
trousers - die Hose