chmura - die Wolke
śliwka - die Pflaume
makaron - die Nudeln
Która godzina? - Wie spät ist es?
Tylko trochę mówię po niemiecku - Ich spreche nur ein bisschen Deutsch
Przykro mi - Es tut mir leid
cierpienie, ból (2) - das Leid / der Schmerz
klawiatura - die Tastatur
głośny - laut
ciemny - dunkel
wyraźny - deutlich
silny - stark
niebezpieczny - gefährlich
rzucać - werfen
zwierze - das Tier
czapka - die Mütze
ucho - das Ohr
piłka - der Ball
słońce - die Sonne
zebra - das Zebra
żyrafa - die Giraffe
krowa - die Kuh
świnia - das Schwein
kura - das Huhn
owca - das Schaf
dywan - der Teppich
smażyć - braten
zdrowy - gesund
chory - krank
państwo - der Staat
papier - das Papier
ser - der Käse
szynka - der Schinken
mięso - das Fleisch
jajko - das Ei
winogrono - die Traube