bed - das Bett
blanket - die Decke
pillow - das Kissen
leg - das Bein
shelve - das Regal
closet - der Schrank
door - die Tür
electric socket - die Steckdose
drawer - die Schublade
TV - der Fernseher
shampoo - das Shampoo
building - das Gebäude
house - das Haus
ruler - das Lineal
pencil - der Bleistift
pencil case - das Mäppchen
rubber - der Radiergummi
knife - das Messel
fork - die Gabel
spoon - der Löffel
way - der Weg
school - die Schule
train - der Zug
bus - der Bus
car - der Wagen
sky - der Himmel
Thursday - der Donnerstag
kitchen - die Küche
tap - der Hahn
forest - der Wald