book - das Buch
window - das Fenster
wall - die Wand
flower - die Blume
wallet - die Geldbörse
mirror - der Spiegel
basket - der Korb
key - der Schlüssel
coat - die Jacke
shoe - der Schuh
fridge - der Kühlschrank
table - der Tisch
char - der Stuhl
oven - der Ofen
cooker - der Herd
microwave - die Mikrowelle
fruit - die Frucht
vegetable - das Gemüse
plate - der Teller
bowl - die Schüssel
banana - die Banane
apple - der Apfel
tree - der Baum
arm - der Arm
eye - das Auge
face - das Gesicht
nose - die Nase
glass - das Glas
lemon - die Zitrone
bread - das Brot
stomach - der Bauch
soap - die Seife
shower - die Dusche
dishwasher - der Geschirrspüler
washing machine - die Waschmaschine
bath - die Wanne
cup - die Tasse
pen - der Kugelschreiber
charger - das Ladegerät