death - der Tod
pomysł - der Gedanke
serce - das Herz
jaskinia - die Höhle
obawiać się - fürchten
płot - der Zaun
wspaniały - herrlich
siła - die Kraft
oszczędny - sparsam
szczególnie, wyjątkowo - besonders
pracowity - fleißig
mówić - sagen
że - dass
tam, tutaj - da
dumny - stolz
opuszczać - verlassen
tablica - die Tafel
góra - der Berg
ziemia - die Erde
około - etwa
wziąć, brać - nehmen
król - der König
zamek - das Schloss
wygrywać - gewinnen
pisarz - der Schriftsteller
krajobraz - die Landschaft
niszczyć - zerstören
budynek - der Bau
żółty - gelb
zielony - grün
